
###,###,###,###,###,###,###,###,###,###,###,###,###,###,###,###,###,###,###,###
###,###,###,###,###,###,###,###,###,###,###,###,###,###,###,###,###,###,###,###
###,###,###,###,###,###,###,###,###,###,###,###,###,###,###,###,###,###,###,###
###,###,###,###,###,###,###,###,###,###,###,###,###,###,###,###,###,###,###,###
###,###,###,###,###,###,###,###,###,###,###,###,###,###,###,###,###,###,###,###
###,###,###,###,###,###,###,###,###,###,###,###,###,###,###,###,###,###,###,###
###,###,###,###,###,###,###,###,###,###,###,###,###,###,###,###,###,###,###,###
###,###,###,###,###,###,###,###,###,###,###,###,###,###,###,###,###,###,###,###
###,###,###,###,###,###,###,###,###,###,###,###,###,###,###,###,###,###,###,###
###,###,###,###,###,###,###,###,###,###,###,###,###,###,###,###,###,###,###,###
###,###,###,###,###,###,###,###,013,014,###,###,###,###,###,###,###,###,###,###
###,###,###,###,###,###,###,###,###,###,###,###,###,###,###,###,###,###,###,###
###,###,###,###,###,###,###,###,###,###,###,###,###,###,###,###,###,###,###,###
###,###,###,###,###,###,###,###,###,###,###,###,###,###,###,###,###,###,###,###
###,###,###,###,###,###,###,###,###,###,###,###,###,###,###,###,###,###,###,###