
###,###,###,###,###,###,###,###,###,###,###,###,###,###,###,###,###,###,###,###
###,###,###,###,###,###,001,001,001,###,###,###,001,001,001,###,###,###,###,###
###,###,###,###,###,###,001,###,001,###,###,###,001,###,001,###,###,###,###,###
###,###,###,###,###,###,###,###,###,###,###,###,###,###,###,###,###,###,###,###
###,###,###,###,###,###,002,002,###,###,###,###,###,003,003,###,###,###,###,###
###,###,###,###,###,###,002,###,###,###,###,###,###,003,003,###,###,###,###,###
###,###,###,###,###,###,002,###,###,###,###,###,###,003,003,###,###,###,###,###
###,###,###,###,###,###,002,002,###,###,###,###,###,003,003,###,###,###,###,###
###,###,###,###,###,###,002,002,###,###,###,###,###,003,003,###,###,###,###,###
###,###,###,###,###,###,002,002,###,###,###,###,###,003,003,###,###,###,###,###
###,###,###,###,###,###,002,002,###,###,###,###,###,003,003,###,###,###,###,###
###,###,###,###,###,###,###,###,###,###,###,###,###,###,###,###,###,###,###,###
###,###,###,###,###,###,###,###,###,###,###,###,###,###,###,###,###,###,###,###
###,###,###,###,###,###,###,###,###,###,###,###,###,###,###,###,###,###,###,###
###,###,###,###,###,###,###,###,###,###,###,###,###,###,###,###,###,###,###,###